{
    "music": "music_polarbear",
    "width": 11,
    "height": 11,
    "backgroundLayers": [
        { "id": "ground", "opacity": 1, "autoGenerate": false },
        { "id": "border", "opacity": 1, "autoGenerate": true },
        { "id": "decoration", "opacity": 1, "autoGenerate": false },
        { "id": "overlay", "opacity": 1, "autoGenerate": true }
    ],
    "foregroundLayers": [ 
        { "id": "cloud", "opacity": 1, "autoGenerate": false }
    ],
    "metaLayers": [
        { "id": "type", "opacity": 1, "autoGenerate": false },
        { "id": "team", "opacity": 1, "autoGenerate": false }
    ],
    "layers": {
        "ground": [
            4,4,4,5,5,4,5,5,4,4,4,
            4,10,10,5,5,10,5,4,10,10,5,
            4,5,10,10,10,10,10,10,10,4,4,
            4,4,5,4,5,5,4,5,4,5,4,
            5,5,5,10,4,10,10,10,5,5,5,
            5,4,5,10,10,10,5,10,5,4,5,
            4,5,5,5,4,4,5,5,4,4,5,
            4,5,10,10,10,10,10,10,4,4,5,
            4,10,10,5,10,5,5,10,5,5,4,
            4,10,4,5,5,4,4,10,10,10,4,
            4,5,4,5,5,5,4,5,4,4,5
        ],
        "decoration": [
            0,0,0,307,303,0,0,0,0,0,0,
            0,605,605,0,0,605,0,0,605,605,0,
            0,0,605,605,605,605,605,605,605,0,0,
            0,0,0,0,0,0,0,0,0,0,0,
            0,0,0,605,0,605,605,605,0,0,0,
            0,0,0,605,605,605,0,605,0,0,0,
            0,0,0,0,0,0,0,0,0,0,0,
            0,0,605,605,605,605,605,605,0,0,0,
            0,605,605,0,605,0,0,605,0,0,0,
            0,605,0,0,0,0,0,605,605,605,0,
            0,0,0,0,0,0,0,0,0,0,0
        ],
        "cloud": [
            0,0,0,0,0,0,0,0,0,0,0,
            0,0,0,0,0,0,0,0,0,0,0,
            0,0,0,0,0,0,0,0,0,0,0,
            0,0,0,0,0,0,0,0,0,0,0,
            0,0,0,0,0,0,0,0,0,0,0,
            0,0,0,0,0,0,0,0,0,0,0,
            0,0,0,0,0,0,0,0,0,0,0,
            0,0,0,0,0,0,0,0,0,0,0,
            0,0,0,0,0,0,0,0,0,0,0,
            0,0,0,0,0,0,0,0,0,0,0,
            0,0,0,0,0,0,0,0,0,0,0
        ],
        "type": [
            0,0,0,0,0,0,0,0,0,0,0,
            0,1,1,0,0,1,0,0,1,1,0,
            0,0,1,1,1,1,1,1,1,0,0,
            0,0,0,0,0,0,0,0,0,0,0,
            0,0,0,1,0,1,1,1,0,0,0,
            0,0,0,1,1,1,0,1,0,0,0,
            0,0,0,0,0,0,0,0,0,0,0,
            0,0,1,1,1,1,1,1,0,0,0,
            0,1,1,0,1,0,0,1,0,0,0,
            0,1,0,0,0,0,0,1,1,1,0,
            0,0,0,0,0,0,0,0,0,0,0
        ],
        "team": [
            1,1,1,1,1,1,1,1,1,1,1,
            1,1,1,1,1,1,1,1,1,1,1,
            1,1,1,1,1,1,1,1,1,1,1,
            1,1,1,1,1,1,1,1,1,1,1,
            1,1,1,1,1,1,1,1,1,1,1,
            1,1,1,1,1,1,1,1,1,1,1,
            1,1,1,1,1,1,1,1,1,1,1,
            1,1,1,1,1,1,1,1,1,1,1,
            1,1,1,1,1,1,1,1,1,1,1,
            1,1,1,1,1,1,1,1,1,1,1,
            1,1,1,1,1,1,1,1,1,1,1
        ]
    },
    "entities" : [
        
    ],
    "flags" : {
      
    }
}